F 139,99,58
C 171,154,137

SO textures/door.png
NO textures/door.png
WE textures/door.png
EA textures/door.png

1111111111111111111
1E000000000000000001
1111111111111111111